#########################################
#S#           #     # #     #           #
# # ### ##### ### ### # ##### ##### ### #
# # #   #     #   # #   #   # #   #   # #
# # # ### ### ### # ##### # # # # ##### #
#   #   # # #     #     # #   # #     # #
#~  #~ ~#~#~#~##~##~##~##~#~###~###~###~#
#~  #~  # # # ~      ~ ~#~#~~~#~~ ~~#~  #
#~# ### # # #~#~#~###~###~##~##~####~####
# #~ ~#  ~# # # #~~   ~~#~  #~#~~  ~ ~  #
#~### ###~#~#~###~###~#~#~#~#~##~##~###~#
#~ ~#~ ~#~ ~#~     ~~~ ~#~ ~#~#~ ~# ~ ~~#
### # # # # # # # # # ### ### # # ##### #
# #   # #   #   # # #     #   # #   #   #
# ##### ### ### ### ### ### # # # ### # #
#     #   #   # #   #   #   # # #   # # #
##### ### ### # # ### # # ### # # # # # #
#   #   # #   #   # # # #         #    E#
#########################################