#########################################
#S#           #     # #     #           #
# # ### ##### ### ### # ##### ##### ### #
# # #   #     #   # #   #   # #   #   # #
# # # ### ### ### # ##### # # # # ##### #
#   #   # # #     #     # #   # #     # #
##### # # # ## ## ## ## # ### ### ### # #
#   # # # #           # #   #     #   # #
# # ### # # # # ### ### ## ## #### #### #
# #   #   # # # #       #   # #         #
# ### ### # # ### ### # # # # ## ## ### #
#   #   #   #           #   # #   #     #
### # # # # # # # # # ### ### # # ##### #
# #   # #   #   # # #     #   # #   #   #
# ##### ### ### ### ### ### # # # ### # #
#     #   #   # #   #   #   # # #   # # #
##### ### ### # # ### # # ### # # # # # #
#   #   # #   #   # # # #         #    E#
#########################################